%%%%%%%%%%%%%%%%%%%%
%.           . %   %
% %%.%%.%%.%%.%% % %
%        P     o % %
%%%%%%%%%%%%%%%%%% %
%..  .             %
%%%%%%%%%%%%%%%%%%%%